111111
100001
1C0101
100C01
100P01
100001
111111
