11111
100P1
10001
10P01
11111
