1111111111
1000000001
100E001101
1001110011
1000P00001
100000P001
1000000001
1111111111
