1111111111
1000100011
1000C00011
1100000101
100000E0C1
100P00CC01
1000000001
1111111111