11111111111111111111
1000C00010000P000001
10000C00000C11100011
100011100000C0000001
10E00000000000000001
1000C00C011111000001
10000000000001000001
10000111110000100001
10000000000000000001
10C00000000000111001
1000001C00000C000001
1000C000000000000001
10001000010000000001
11111111111111111111
