1111
1001
1001
1001
1001
1011
