11111111111111
10000001000001
01000110001001
11111111111111
